10 10
X X X X X X X X X X
X S . . . . . . . X
X X X X X . X X X X
X . . . . . X . . X
X . X . X . X X . X
X . X . . . X X . X
X . X X X . . . . X
X . X . X X X X . X
X . . . . . . . Q X
X X X X X X X X X X